Kedvenc drum & bass lemezek (2002 Július):

PASCAL /watershed ep	 	TPR 042
MATHEMATICS / styles for miles		CD-R
TOTAL SCIENCE / philly x		ADVRSK 003
MATHEMATICS / fantasy		CD-R
DJ TEEBEE / guilty		SUBTITLES 023
C4C / eggplant	 	RL 002
LEMON D / stomper	 	CHR 020
RAM TRILOGY / chapter 6		RAMM 041
ANORGANIK feat. SENA / endlessly		CD-R
MORCHEEBA / otherwise	uncut rmx	EAST WEST

Kedvenc lemezek (2002. szeptember):

lemon jelly / lost horizons	 	XL LP CD-R
rednose distrikt / n.y. boom		RH 009
deadly avenger / punisher		DEAD 001
primal scream / miss lucifer	jagz kooner mix	COLUMBIA
frogsnatcher / dream rabbit	original mix	AFR 020
joseph malik / futuristica	grand unified rmx	CPT 112
jazzanova / days to come	ayro mix	JCR 032
quantic / off the beaten track	carmel rmx	TRU CD-R
andy page & babs / oblivia newton bomb		THUNK 030
radiohead / everything it it's right place	hybrid rmx	CD-R
the apollo kids / the dumz	 	FAT 005
marcel / jealous		EARTH 006
i-wolf presents soul strata / positivity	chris. candid rmx	KLEIN 038
percusound / the call of the jungle	jungle mix	R 008
koop / waltz for koop	patife vocal mix	STI 004
dj marky & xrs feat. stamina mc / lk	 	V 035
one:soul / spend the night	total science rmx	HEDGE 010R
dj zinc / fair fight		BINGO 008
bebel gilberto / so nice	marky rmx	EAST WEST
drumagick / easy boom		MERCURY
marcel / everytime you touch me		GLR CD-R
boozoo bajou f. wayne martin / camioux		SD 085
dzihan & kamien / ford transit		COUCH
sleng teng / who we be	(d.m.x. remix)	STINGER "7
homelife / flying wonders		ZEN 071 LP

Kedvenc lemezek (2002. november):

amb / romeo		DUB
adam f / dirty harry's revenge rmxs		KAOS 004
drumsound & simon 'bassline' smith / freestyle mambo		V 039
bad company / shot down on safari		BCRLP 002
i & i vs ray keith / don't get me wrong	ray keith vocal rmx	AK 001
bounty killer terror fabulous / vote		SE 002
sizzla / to rahtid		FSTEPS "7
capleton / she is my life		MF 102 "7
tlc & general levy / bam bam rmx		EIT 002
daddy / better than you		FAT 007
enduro / global greed	sofa surfers rmx	TST 010
trevira modern / danubian rhapsody		UGAR 028
dr.rich & m.d.l.a./ back to back		WHITE
dreadzone vs mafia tone / the warriors		DBLS 004
london funk society / now what we found		SUMI 003
solid ground / true liberation	sons of slough rmx	W9Y 027
xav / money shot		BBV 012
harmonic 33 / extraordinary people		AZ 002
fitchie f. joe dukie / midnight marauders		SB 010
los chicharrons / love magic		VOOD 007

Kedvenc lemezek (2003/01)	

total science / prozac	ADVRSK 005
d. kay + dj lee / manipulate the universe	ADVRSK 005
kyoto jazz massive / the brightness of these days (quantic rmx)	CPT 120
quantic / off the beaten track (carmel rmx)	TRU
layo & bushwacka! / love story (stanton warriors rmx)	XL 154
chris carter / ladybird RENN 070
lbj / syvalle/this one	BOS 038
donna / kebab	BOOTLEG
soul of man / acid punch	FLR 037
jhz / azures/ping	BBV 014
various artists / crash & carry	CHI 003/004
aquasky vs masterblaster / all in check (atomic hooligan rmx)	BOS 039
panjabi mc / mundian to bach ke	KARMA 028
trevira modern / danubian rhapsody	UGAR 028
pest / jefferson shuffle	ZEN 123
capleton / too much	QUALITY "7
degree / shock out	Q45 "7
elijah prophet / life is a jungle	ARTISTIC "7
buelent / to me	SD 097
seelenluft / l.a. woman (bob goes to hollywood mix)	KLEIN 039

Kedvenc magyar lemezek (2003/03)	

carmel / biznizzman	TRU CD-R
amb / romeo	CHI 003
amb / tuff enuff	COC 006
modul f. busa / boomstickie (modul rmx)	CD-R
skc /limelight	CD-R
chris.su + skc / blackout rmx CD-R
bob & rocky / hold it now	CD-R
korai öröm / 6 (beatman & ludmilla rmx)	CD-R
robertsch / photo album	HTC 001
trevira modern / danubian rhapsody	UGAR 028

Kedvenc lemezek (2003/04/23)	

spectre / psychic wars	WSLP 045
the bug / beats, bombs, bass, weapons	KLEIN 041
bangalore / sona sona	LE 011
junkie xl / catch up to my step (extended)	ROADRUNNER
mr.scruff / sweetsmoke (manitoba rmx)	ZEN 134
carmel / biznizzman	TRU CD-R
kaori / good life (crate soul brothers rmx)	CD-R
kid & khan / goo goo muck	CITYSEVEN
the beginerz / reckless girl (stanton warriors rmx) WHITE
meat katie + elite force / ju ju (apollo kids rmx)	RENN 073
modul / boomstickie (modul rmx)	CHI CD-R
unknown / the lucky ones	WHITE
reno raines / renegade breaks	REN 001
twisted individual / pony pleasure	NIR 025
london elektricity / billion $ gravy	NHS 055
architex ft ayah / dance child	SIGNAL 001
special forces / the end (rmx)	PPRO 007
drumsound & bassline smith / fallin'	FORM 100
skc + safair / free my soul	CD-R
loopless / blue and yellow bird	NYLONCD 006

Kedvenc lemezek (2003/07/22)	

big bud / catch 22 (membran remix)	CD-R
deekline & wizard / sun is shining	BOS 042
capleton / wha dat (raw)	SRC "7
ram trilogy / screamer	RAMM 044
dj shadow / the latest single	ISLAND
manitoba / hendrix with ko	DOCK 036
kaori / good life (sero muki does it)	DUB
adam freeland / smell like freeland	SLF 001
blim & rennie pilgrem / 2 freaks (club mix) RENN 074
chris.su / speedy	DUB
zero / emit/collect (pilgrim's agatha stomp)	STW 005
underworld / cowgirl/rez (atomic hooligan remixes)	UWORLD001
koma&bones / black satsuma	RENN 077
tricknology 2	TRIX 002
chris.su / need u tonite	DUB
skc + safair / free my soul	DUB
pendulum / vault	31R 019
skc / limelight (vip)	DUB
boogaloo / you gotta have freedom	GAMM 003
the lee sankey remix project	LS 004

Kedvenc lemezek (2003/10/26)	

beenie man feat. lady saw & sean paul / bossman	VUST 274
jonny l / geronimo	PIHCD 001
infrared v’s gil felix / capoeira	INFRA 024
maga bo / tanto faz (quantic mix)	TRU 053
!deladap / amaro shavo / gi	EC 3836
noha / balkan hot step	UNIQ 076
spiritual south / green gold	AFR 025
inverse cinematics / shoot the pianist (part 1) FLOZ 010
carmel / biznizzman/musical prostitute	TRU EP
beatman & ludmilla / vavyan	DUB
cane matto / taxi/what it is!	1I 004
basement jaxx / lucky star	XL 174
chris carter / bottyfunk	ENVISION 009
chicken lips / she not in (stanton warriors remix)	PUNKS 002
on a ragga boot / shotgun bootleg	FLY 002
jason sparks / secret place (blim/deekline remixes)	BOS 043R
smithmonger / nobody gonna stop us	RENN 078
felix da housecat / cyberwhore	ZRP 001
vigi / blow my mind (general midi remix)	STW 008
underworld / born slippy (atomic hooligan remix)	JBO 247
freq nasty feat. rodney p / come let me know (freq vs blim remix)	SKINT 085
nubreed / bring that sound	MOBLP 003
lbj / haikea jouppo	BBV 018
presser / 2black2gay (friendly remix)	CTFAT 016
r. pilgrem v deekline / rippin’ up wax (deekline & ed solo mix)	RAT 018
aquasky vs. masterblaster feat. daddy freddy / war	CRYPTIC CD
metallica / frantic (unkle remix)	VERTIGO
concord down / raining blood	RH 050
kiko & rob f / beholder (chris.su remix)	CD-R
lenny fontana / spread love (nu:tone remix)	NHS 064
skc & bratwa / solitude	CD-R
kid koala / vacation island	ZEN 142
lucky pierre / the heart of all that is (minotaur shock remix)	MELO 019

Kedvenc lemezek (2004/02/06)	

bugle & shadu / bed argument	SHV 7"
elephant man / we no pet dem	BYMG 042 7"
krafty skillz / insane bangers!	NUT 990
la hookers / sexslave	10KG 033
move ya! + steve lavers / dopefreak	ABR 001
plump djs / creepshow	FLR 047
rennie pilgrem / defender	TCR
beastie boys / fight for your right (skool of thought bootleg)	CD-R
ferry corsten / rock your body rock (rennie pilgrem remix)	TIVDJX 202
meat katie & christian j / turn me out	KS 084
scam / killer	DC 003
klaus hill / northern lights	MOB 026
freestylers / punks (krafty kuts remix)	ATG 008
chris.su + skc / desert siege	CD-R
mindscape / hideout CD-R
tali / blazin' (dillinja remix) FCY 059
d kay + dj lee / one 2 three	METRO CD
soulproof / on the line	CD-R
yonderboi / splendid isolation	CD-R
nostalgia 77 / songs for my funeral	TRU CD 059

Kedvenc lemezek (2004/03/31)	

marcel / gamblers' delight	GLR CD
unknown / save us	DEMO
telemen / in all nothing (adam freeland&evil nine remix)	MCR 1290
precision cuts / big time roller	SIMPLE 0408
northend / cant put no price (deekline mix)	WACKT 006
the booty bouncers / fame & money	RAT DEMO
the booty bouncers / get dirty baby (friendly remix)	RAT TP
unknown / outta space (booty space mix)	CAR 002
deekline & wizard / bodypopper	BOS 045R
backdraft / labrat	PASA 014
distortionz / hitman	HB 008
c83 feat. tamra / twisted logic	ENVISION 01
mathematics + tactile / jumpin'	CD-R
tactile / mist	CD-R
trace + tactile / in my brain CD-R
skc & chris.su / crash CD-R
skc / dominion	CD-R
cyantific / little green man	NHS 071
mathematics + tactile / in-out	CD-R
dynamo dresden / playtime	MADA 008

Kedvenc lemezek (2005/08/24)	

DIGITAL / no more violence (tactile rmx 1)	FUNCTION CD
MOONDOG and his friends	HJP 024
DJ FOOD / raiding the 20th century	WWW.UBU.COM
DJ SEEN / phonogram	CPDS1001
ALICE RUSSEL / humankind	TRUEP 084
SHPONGLE / nothing lasts.but nothing is lost	TWSLP 028
PENDULUM / hold your colour	BBK 002LP
TIMO MAAS / pictures	WARNERLP
ERIK SUMO / this is where it began	PULVER 025
INFEKTO / the real funk	MONEY 003
STANTON WARRIORS / pop ya cork	PUNKS 005
SUGAR SHAK / sunshine days	WHITE
SMITHMONGER / kobie grizzle	CDR
BEATMAN & LUDMILLA / ghost in the shell	VB 995
FLACK.SU / toddler (blim rmx) CHI CD
JHZ / chips REC 004
UNKNOWN / insomniac	CDR
AQUASKY vs MEAT KATIE / overneath	PASA CD
KIRO vs UNDECIDED/ obsessive nature (rogue element rmx)	MOB 032
SPROCKET / kickflip (smithmonger rmx)	CDR
A-SPARK / try playing it live	CDR
CUT & RUN / murder in the jamrock	CAR CD
PRODIGY / voodoo people (pendulum rmx)	XLT 219
UNKNOWN / pump fiction	WHITE
J LAZE ft LADEE BERRY / summertime	SQUARE 001
TACTILE / chrome	CDR
DRIFTER / she gives me forever	TIMEWAVE 001
JONTEY / summer time	CDR
TRENDY FIVE / face the fact	CDR
RAZ MESINAI / letter to milena	CDR

Kedvenc lemezek (2006/04)	

ANIMA SOUND SYSTEM / we strike!	CLS CD
GOTAN PROJECT / lunático	YAB 023LP
JEFF MILLS / blue potential	UWEDVD 007
VARIOUS / the human resource	HUMA 8019
JUANA MOLINA / son	WIGCD 176
HERBERT / scale	!K7 202
ZERO DB / bongos,bleeps & basslines	ZEN 180
MAKOSSA & MEGABLAST / like a rocket ft capitol a	GSMX 1026
FRANZ FERDINAND / the fallen (justice rmx)	RUG 219T
RAKES / 22grand job (filthy dukes rmx)	CDR
COLDCUT / tru skool (switch rmx)	ZEN 12178
BASSBIN TWINS / gun down	MAPA 037
WILL SOUL ft URSULA RUCKER / where is it? (evil nine rmx)	AIRFIX 004P
JIM SHIMMER / space races	SVN CD
BLIM vs JHZ / widgee TRACK CD
BACK DOOR HUSSIES / i wanna feel ya 10KG 048
SOTO / ghetto blast ya	MENU CD
GEEK GHASTLY / rage against terror	ROCK 002
CUT & RUN / public enema / loneliness	CAR 014CD
DEEKLINE & WIZARD / special dedication vip	CDR
AQUASKY & BACKDRAFT / what can you do (club mix)	PASA CD
IVORY / the wolf (control z rmx)	RAT CD
CONTROL Z / kung fu funk	HB 018
SKC / cold sweat	SUICIDE CD
AQUASKY / time up (drumsound & simon bassline smith rmx)	PASA CD
MASHEEN / splash back	DSCI4 CD
INFILTRATA & HOCHI ft MENTAL SHARP / hit 'em hard	TEKDBZ 005
MATT U / mosaic	CDR
MUNK & DIS / untitled	CDR
CONCORD DOWN / say your words	METH 071
 

