Kedvenc lemezek (2005/08/24)	

DIGITAL / no more violence (tactile rmx 1)	FUNCTION CD

MOONDOG and his friends	HJP 024

DJ FOOD / raiding the 20th century	WWW.UBU.COM

DJ SEEN / phonogram	CPDS1001

ALICE RUSSEL / humankind	TRUEP 084

SHPONGLE / nothing lasts.but nothing is lost	TWSLP 028

PENDULUM / hold your colour	BBK 002LP

TIMO MAAS / pictures	WARNERLP

ERIK SUMO / this is where it began	PULVER 025

INFEKTO / the real funk	MONEY 003

STANTON WARRIORS / pop ya cork	PUNKS 005

SUGAR SHAK / sunshine days	WHITE

SMITHMONGER / kobie grizzle	CDR

BEATMAN & LUDMILLA / ghost in the shell	VB 995

FLACK.SU / toddler (blim rmx)
CHI CD

JHZ / chips

REC 004

UNKNOWN / insomniac	CDR

AQUASKY vs MEAT KATIE / overneath	PASA CD

KIRO vs UNDECIDED/ obsessive nature (rogue element rmx)	MOB 032

SPROCKET / kickflip (smithmonger rmx)	CDR

A-SPARK / try playing it live	CDR

CUT & RUN / murder in the jamrock	CAR CD

PRODIGY / voodoo people (pendulum rmx)	XLT 219

UNKNOWN / pump fiction	WHITE

J LAZE ft LADEE BERRY / summertime	SQUARE 001

TACTILE / chrome	CDR

DRIFTER / she gives me forever	TIMEWAVE 001

JONTEY / summer time	CDR

TRENDY FIVE / face the fact	CDR

RAZ MESINAI / letter to milena	CDR
 
 
