Kedvenc lemezek (2003/10/26)	

beenie man feat. lady saw & sean paul / bossman	VUST 274

jonny l / geronimo	PIHCD 001

infrared v’s gil felix / capoeira	INFRA 024

maga bo / tanto faz (quantic mix)	TRU 053

!deladap / amaro shavo / gi	EC 3836

noha / balkan hot step	UNIQ 076

spiritual south / green gold	AFR 025

inverse cinematics / shoot the pianist (part 1)
FLOZ 010

carmel / biznizzman/musical prostitute	TRU EP

beatman & ludmilla / vavyan	DUB

cane matto / taxi/what it is!	1I 004

basement jaxx / lucky star	XL 174

chris carter / bottyfunk	ENVISION 009

chicken lips / she not in (stanton warriors remix)	PUNKS 002

on a ragga boot / shotgun bootleg	FLY 002

jason sparks / secret place (blim/deekline remixes)	BOS 043R

smithmonger / nobody gonna stop us	RENN 078

felix da housecat / cyberwhore	ZRP 001

vigi / blow my mind (general midi remix)	STW 008

underworld / born slippy (atomic hooligan remix)	JBO 247

freq nasty feat. rodney p / come let me know (freq vs blim remix)	SKINT 085

nubreed / bring that sound	MOBLP 003

lbj / haikea jouppo	BBV 018

presser / 2black2gay (friendly remix)	CTFAT 016

r. pilgrem v deekline / rippin’ up wax (deekline & ed solo mix)	RAT 018

aquasky vs. masterblaster feat. daddy freddy / war	CRYPTIC CD

metallica / frantic (unkle remix)	VERTIGO

concord down / raining blood	RH 050

kiko & rob f / beholder (chris.su remix)	CD-R

lenny fontana / spread love (nu:tone remix)	NHS 064

skc & bratwa / solitude	CD-R

kid koala / vacation island	ZEN 142

lucky pierre / the heart of all that is (minotaur shock remix)	MELO 019
 