Kedvenc lemezek (2003/04/23)	

spectre / psychic wars	WSLP 045

the bug / beats, bombs, bass, weapons	KLEIN 041

bangalore / sona sona	LE 011

junkie xl / catch up to my step (extended)	ROADRUNNER

mr.scruff / sweetsmoke (manitoba rmx)	ZEN 134

carmel / biznizzman	TRU CD-R

kaori / good life (crate soul brothers rmx)	CD-R

kid & khan / goo goo muck	CITYSEVEN

the beginerz / reckless girl (stanton warriors rmx)
WHITE

meat katie + elite force / ju ju (apollo kids rmx)	RENN 073

modul / boomstickie (modul rmx)	CHI CD-R

unknown / the lucky ones	WHITE

reno raines / renegade breaks	REN 001

twisted individual / pony pleasure	NIR 025

london elektricity / billion $ gravy	NHS 055

architex ft ayah / dance child	SIGNAL 001

special forces / the end (rmx)	PPRO 007

drumsound & bassline smith / fallin'	FORM 100

skc + safair / free my soul	CD-R

loopless / blue and yellow bird	NYLONCD 006
